############################################################
############################################################
############################################################
############################################################
###############.....########################################
###############.....###..........###########################
######...######.....##............#######..........#########
#####.....#######o###..............................#########
u..................................................#########
#####.....###########..............................#########
######...#############............#######..........#########
#######################..........########oo#################
########################################....################
########################################....################
############################################################
