###########################00###############################
###########################uu###############################
###########################..###############################
###########################..###############################
###########################..###############################
#######################..........###########################
######################............##########################
#####################..............#########################
#####################..............#########################
#####################..............#########################
######################............##########################
#######################..........###########################
############################################################
############################################################
############################################################
