############################################################
############################################################
###.......................................................##
###.......................................................##
###.......................................................##
###.......................................................##
###.......................................................##
###.......................................................##
###.......................................................##
###.......................................................##
###.......................................................##
###........................................##..#############
###........................................##..#############
#############################################uu#############
#############################################00#############
